....||..............||....
.||.||.||||||||||||.||.||.
.||.||.||||||||||||.||.||.
.||......||....||......||.
.|||||||.||.||.||.|||||||.
.|||||||.||.||.||.|||||||.
......||....||....||......
||.||.||.||.||.||.||.||.||
||.||....||.||.||....||.||
...||.||.||.||.||.||.||...
.||||.||..........||.||||.
.||||.||.||||||||.||.||||.
...||....||||||||....||...
||.|||||.||||||||.|||||.||
||.|||||.||||||||.|||||.||
......||.||||||||.||......
.||||.||..........||.||||.
.||||.||.||.||.||.||.||||.
.||||.||.||.||.||.||.||||.
.........||.||.||.........
|||.|||||||.||.|||||||.|||
|||.|||||||.||.|||||||.|||
.......||........||.......
|||.||.||.||||||.||.||.|||
|||.||.||.||||||.||.||.|||
|||.||..............||.|||
|||.|||||||.||.|||||||.|||
|||.|||||||.||.|||||||.|||
............||............