....||..............||....
|||.||.||||||||||||.||.|||
|||.||.||||||||||||.||.|||
|||....||........||....|||
|||.||.||.||||||.||.||.|||
|||.||....||||||....||.|||
....||.||.||||||.||.||....
.||.||.||........||.||.||.
.||.||.||||||||||||.||.||.
.||.||.||||||||||||.||.||.
..........................
.|||||||.||||||||.|||||||.
.|||||||.||||||||.|||||||.
.||......||||||||......||.
.||.||||.||||||||.||||.||.
....||||.||||||||.||||....
||||||..............||||||
||||||.||||||||||||.||||||
.......||||||||||||.......
.|||.||||........||||.|||.
.|||.||||.||||||.||||.|||.
.......||.||||||.||.......
||||||.||........||.||||||
||||||.||.||||||.||.||||||
....||.||.||||||.||.||....
.||.||.||........||.||.||.
.||....||.||||||.||....||.
.||.||.||.||||||.||.||.||.
....||..............||....