.........||....||.........
.||.||||.||.||.||.||||.||.
.||.||||....||....||||.||.
.||...||.||||||||.||...||.
.||||.||.||||||||.||.||||.
.||||.||.||....||.||.||||.
.........||.||.||.........
|||.||||.||.||.||.||||.|||
|||.||||.||.||.||.||||.|||
....||||.||.||.||.||||....
.||....................||.
.||.||||.||||||||.||||.||.
.||.||||.||||||||.||||.||.
.........||||||||.........
.|||||||.||||||||.|||||||.
.|||||||.||||||||.|||||||.
.||....................||.
.||.||.||||.||.||||.||.||.
.||.||.||||.||.||||.||.||.
....||...||.||.||...||....
||||||||.||.||.||.||||||||
||||||||.||.||.||.||||||||
.........||....||.........
.|||||.||||.||.||||.|||||.
.|||||.||||.||.||||.|||||.
.|||||......||......|||||.
.|||||.||||||||||||.|||||.
.|||||.||||||||||||.|||||.
..........................