.........||....||.........
.||.||||.||.||.||.||||.||.
.||.||||....||....||||.||.
.||...||.||||||||.||...||.
.||||.||.||||||||.||.||||.
.||||.||.||....||.||.||||.
.........||.||.||.........
|||.||||.||.||.||.||||.|||
|||.||||.||.||.||.||||.|||
.||.||||.||.||.||.||||.||.
.||....................||.
.||.||||.||||||||.||||.||.
.||.||||.||||||||.||||.||.
.........||||||||.........
||||||||.||||||||.||||||||
||||||||.||||||||.||||||||
.||....................||.
.||.||.||||.||.||||.||.||.
.||.||.||||.||.||||.||.||.
....||...||.||.||...||....
||||||||.||.||.||.||||||||
||||||||.||.||.||.||||||||
.........||....||.........
.|||||.||||.||.||||.|||||.
.|||||.||||.||.||||.|||||.
.|||||......||......|||||.
.|||||.||||||||||||.|||||.
.|||||.||||||||||||.|||||.
..........................